2 13 31
###############################
#p * *2  5    *  ** * *      *#
# # # # #*# # #*# # # # # #*# #
#    * * *** **   5  *    **  #
#x#*# # # # #1# #b#1# # # # #*#
#    2     *     **      *  **#
# # #*# # # # # #*#*#*#*# # # #
#   *  4     *   * * * *      #
# # # # #*# # # # # # #*# #*# #
#   ****         *1           #
# # # # # # # # # #*# # # # #*#
#  ** * 4 *    2              #
###############################
