2 13 31
###############################
#p * *2  5    *  ** * *      *#
# # # # #*# # #*# # # # # #*# #
#    * * *** **      *    **  #
#x#*# # # # #1# #b#1# # # # #*#
#          *     **      *  **#
# # #*# # # # # #*#*#*#*# # # #
#   *        *   * * * *      #
# # # # #*# # # # # # #*# #*# #
#   ****         *1           #
# # # # # # # # # #*# # # # #*#
#  ** *   *    2              #
###############################
